LN:Advanced Level
GD:120
MP:3
ET:2
ED:1
ER:3
RS:1
PR:10
PO:100
GRD:19:13
WWWWWWWWWWWWWWWWWWW
W-2-----R----O----W
WWOW-W-W-W-W-W-W-WW
W-O--O-----R------W
WWOWOW-W-W-W-WOW-WW
W--O-----1--O-R--3W
WW-W-W-W-W-W-W-W--W
W--O-O--O--O-O---OW
WWOW-WOWOW-W-W-W-WW
W--O-OO--R---W----W
WW-WRWOWOW-WOWOWOWW
W4------ROO-O-O-ORW
WWWWWWWWWWWWWWWWWWW