LN:3
GD:120
ET:1
ED:1
ER:3
RS:2
PR:10
PO:100
GRD:19:13
WWWWWWWWWWWWWWWWWWW
W--O--------O-R--3W
WWOW-W-W-W-W-W-W-WW
W-OOOO---1-------OW
WWOWOWOWOW-W-W-W-WW
W-2-----R----O----W
WWOW-W-W-W-W-W-W-WW
W-O--------R------W
WWOWOW-W-W-W-WOW-WW
W--OOOO--R--OOO---W
WW-W-WOWOW-WOWOWOWW
W-----4OOO--OO---RW
WWWWWWWWWWWWWWWWWWW