LN:1
GD:120
ET:2
ED:2
ER:4
RS:0.5
PR:10
PO:100
GRD:19:13
WWWWWWWWWWWWWWWWWWW
W-2-----R----O----W
WWOW-W-W-W-W-W-W-WW
W-O--------R------W
WWOWOW-W-W-W-WOW-WW
W--O--------O-R--3W
WWOW-W-W-W-W-W-W-WW
W-OOOO---1-------OW
WWOWOWOWOW-W-W-W-WW
W--OOOO--R--OOO---W
WW-W-WOWOW-WOWOWOWW
W------OOO--OOO-ORW
WWWWWWWWWWWWWWWWWWW